.........................
.E...E..E..E..E..E..E..E.
.........................
.........................
..B.BBBBBBBBB......BB....
..BB......BBB.....BB.....
BBBGGGGGBBBBSBBBBBBBBBBBB
............S............
............S............
.BBBB.......S.B..........
....BBB.....S.B..........
............S............
BBBBBBBBBBBBBBBBBBGGGGGBB
.........................
.........................
.........................
...1................2....
............X............
.........................
