.........................
..........E..............
...B.....................
...BBB...................
.....BBBBBBBB............
.............BBBB........
..S.W.........BB.........
....WWWW...G..B..........
...........G.............
.........................
.........................
.........................
.........................
.........................
.........................
.........................
...1.....BBB........2....
........BBBBB............
........BBXBB............
