.........................
...E..E...E...E...E..E...
.........................
S......S......S......B...
S......S......B......B...
B......B......S......S...
S......B......S......B...
SBSSBSSBBSBB.BBBBBBBSSSSS
B......S......S......S...
S......B......B......B...
S......B......B......B...
B......S......S......S...
S......B......S......S...
B......B......S......B...
SBBBBSSBSSSSSSSSSBSBBBBBS
.........................
...1................2....
.........................
.........................
