.........................
...E..E...E...E...E..E...
.........................
B......B......B......S...
S......S......S......B...
B......S......B......S...
B......S......B......S...
SSBBBBSSBSBB.BBSSBBSBSSSS
B......B......B......S...
B......S......B......B...
B......S......B......B...
B......B......B......B...
B......B......B......S...
B......S......B......S...
SSBSBSSBSBBBSSSSSBBBBSSBB
.........................
...1................2....
.........................
.........................
