.........................
...E..E...E...E...E..E...
.........................
B......B......S......S...
S......S......S......S...
S......S......S......S...
S......B......B......B...
BSSSBBBSBBBB.SBSBBBBSBBBS
B......S......S......B...
B......B......S......B...
B......B......S......S...
B......S......B......S...
B......B......B......S...
S......S......B......B...
BSBBBSSSSBBSBBSBSBSBSBBBB
.........................
...1................2....
.........................
.........................
