.........................
...E..E...E...E...E..E...
.........................
S......B......B......B...
B......B......B......S...
S......S......S......S...
S......S......S......B...
SBBSBBBSSBSS.BBBBSSSBSSSB
B......S......B......B...
S......B......S......B...
S......B......S......S...
B......B......B......B...
B......B......S......S...
B......S......B......S...
SBBBSBSSSBSSSSBSSSBBSBBSS
.........................
...1................2....
.........................
.........................
