.........................
...E..E...E...E...E..E...
.........................
S......B......B......B...
S......S......S......S...
S......B......B......S...
B......S......S......B...
BBSBSBSSSSBB.BBSSBSSBBBSB
S......B......B......S...
B......S......S......S...
S......B......S......B...
B......B......B......B...
S......S......B......S...
S......B......S......S...
SSBBSSBSSSSBBSSSBBBBBSSSS
.........................
...1................2....
.........................
.........................
