.........................
...E..E...E...E...E..E...
.........................
S......S......B......S...
S......B......B......B...
B......S......B......B...
B......S......B......S...
SSSSSSBBSSBS.SBSBSSBSBSSS
S......B......S......B...
S......S......S......B...
B......S......B......B...
B......S......B......S...
B......S......S......S...
S......B......B......B...
SBSBBBBBSSBSBSSSSSSBSSBBB
.........................
...1................2....
.........................
.........................
