.........................
...E..E...E...E...E..E...
.........................
S......B......S......B...
S......B......B......S...
B......S......S......B...
B......S......S......S...
SSSBBBBBSSSS.BSSBBBSBSSSB
B......S......B......S...
B......S......S......B...
S......S......B......B...
S......B......B......B...
B......S......S......S...
B......S......S......S...
BBSSSSSSBSBBSSBBBBBBSBBSB
.........................
...1................2....
.........................
.........................
