.........................
...E..E...E...E...E..E...
.........................
S......B......S......B...
B......B......B......S...
B......S......S......S...
B......S......S......S...
SSBSSBSBSSSS.BBSBSBBBBBSS
B......S......B......S...
B......B......B......B...
S......B......B......B...
B......B......S......B...
S......S......S......S...
B......S......B......B...
BSBSBBSSBBBSBSBBBBSSBBBBB
.........................
...1................2....
.........................
.........................
