.........................
...E...E....E....E...E...
.........................
..B..B..B..S..S..S.......
.........................
..S..B.....S........S....
.........................
..B..S..S..B........B....
.........................
..B..B..B..B..B.....B....
.........................
..B..B..B..B..B.....B....
.........................
..B..B..S..B..S..B..B....
.........................
.........................
...1.......BBB......2....
...........BXB...........
.........................
