.........................
..E...E...E...E...E...E..
..B...B...B...B...B...B..
.B...B...B...B...B...B...
....B...B...B...B...B....
...S...S...S...S...S...S.
..B...B...B...B...B...B..
.W...W...W...W...W...W...
....B...B...B...B...B....
...B...B...B...B...B...B.
..S...S...S...S...S...S..
.B...B...B...B...B...B...
....B...B...B...B...B....
...B...B...B...B...B...B.
..W...W...W...W...W...W..
.S...S...S...S...S...S...
...1.......SSS......2....
...........SXS...........
.........................
