.........................
...E...E....E....E...E...
.........................
..B..B..B..B.....B.......
.........................
..B..S..B..B.....S..B....
.........................
..S..B.....B..S..........
.........................
..B..B..B..B..S..S.......
.........................
..B..S..S..B..S..........
.........................
.....B..B..B.....S..S....
.........................
.........................
...1.......BBB......2....
...........BXB...........
.........................
