.........................
...E...E....E....E...E...
.........................
..S..B........B.....B....
.........................
..B..B.....B..S..B..B....
.........................
..B..B..B.....B..B..B....
.........................
.....B.....B........S....
.........................
..S..B.....B.....B..B....
.........................
.....B........B.....S....
.........................
.........................
...1.......BBB......2....
...........BXB...........
.........................
