.........................
...E...E....E....E...E...
.........................
..B.....S.....S.....S....
.........................
..B.....B..B..B..B..S....
.........................
..B........S..B..........
.........................
..B..B..B..B..B..........
.........................
.....B........B..B..B....
.........................
..B.....B..B..S..B.......
.........................
.........................
...1.......BBB......2....
...........BXB...........
.........................
