.........................
...E...E....E....E...E...
.........................
..B..B..B..B.....B..B....
.........................
..S..S..B..B..S..S.......
.........................
..B..B..B..B..S..S..B....
.........................
.....B..B..B..B.....S....
.........................
..S..B..S..B..B..B..S....
.........................
..S..B..B..B..B..B..B....
.........................
.........................
...1.......BBB......2....
...........BXB...........
.........................
