.........................
...E...E....E....E...E...
.........................
..S..B.....S........B....
.........................
..B..............B..B....
.........................
..B.....S..B........B....
.........................
..B.....B.....B.....B....
.........................
..B..B..B..S..B..B.......
.........................
..B.....B..B..B.....B....
.........................
.........................
...1.......BBB......2....
...........BXB...........
.........................
